{
  "id": "tutorial-07",
  "name": "Use Undo",
  "map": [
    "########",
    "#P.....#",
    "#..C...#",
    "###R#D##",
    "#..C..E#",
    "#......#",
    "#......#",
    "########"
  ]
}
