{
  "id": "tutorial-06",
  "name": "Route Planning",
  "map": [
    "########",
    "#P.....#",
    "#..C...#",
    "#..R...#",
    "###.#D##",
    "#.....E#",
    "#......#",
    "########"
  ]
}
