{
  "id": "tutorial-11",
  "name": "Stone Pen",
  "map": [
    "########",
    "#P....E#",
    "#..C...#",
    "#..G...#",
    "#..C...#",
    "#......#",
    "#......#",
    "########"
  ]
}
