{
  "id": "tutorial-02",
  "name": "First Push",
  "map": [
    "########",
    "#P.C.E.#",
    "#......#",
    "#......#",
    "#......#",
    "#......#",
    "#......#",
    "########"
  ]
}
